1 1 1 1 1 1 1 1 1 1 1
1 1 1 1 0 7 0 1 1 1 1
1 1 1 1 3 5 3 1 1 1 1
1 1 3 1 0 3 0 1 0 1 1
1 6 0 0 3 5 3 0 0 6 1
1 0 3 3 3 0 0 3 3 0 1
1 1 8 0 0 2 0 3 0 1 1
1 1 1 1 1 1 1 1 1 1 1