1 1 1 1 1 1 1 1 1 1
1 7 1 0 0 3 1 1 1 1
1 0 3 8 4 0 4 0 1 1
1 4 0 3 0 3 3 0 2 1
1 0 3 0 3 0 3 3 0 1
1 1 0 3 0 3 0 1 1 1
1 1 1 1 1 1 1 1 1 1