1 1 1 1 1 1 1 1 1
1 1 1 1 1 0 6 1 1
1 1 0 4 0 3 0 1 1
1 1 3 0 4 0 1 1 1
1 0 0 1 1 1 1 1 1
1 2 0 0 0 3 0 1 1
1 0 4 0 3 0 5 7 1
1 1 1 1 1 1 1 1 1