1 1 1 1 1 1 1 1 1
1 1 1 1 1 0 7 1 1
1 1 0 0 3 0 5 1 1
1 1 0 3 8 8 1 1 1
1 3 4 1 1 1 1 1 1
1 6 3 0 0 0 3 1 1
1 4 0 0 0 3 0 2 1
1 1 1 1 1 1 1 1 1