1 1 1 1 1 1 1 1 1 1
1 2 1 3 0 3 1 1 1 1
1 0 3 8 3 0 3 0 1 1
1 0 0 3 4 3 0 0 4 1
1 0 3 0 3 0 3 7 4 1
1 1 0 3 0 3 0 1 1 1
1 1 1 1 1 1 1 1 1 1