1 1 1 1 1 1 1 1 1 1
1 2 1 6 0 3 1 1 1 1
1 0 3 8 83 0 5 0 1 1
1 3 0 3 0 3 3 0 N 1
1 0 3 0 3 0 3 3 0 1
1 1 0 3 0 3 0 1 1 1
1 1 1 1 1 1 1 1 1 1