1 1 1 1 1 1 1 1
1 1 1 1 7 0 1 1
1 1 1 1 5 3 0 1
1 4 3 1 0 0 0 1
1 0 6 3 0 3 3 1
1 0 1 0 0 0 2 1
1 0 1 1 8 1 1 1
1 0 0 8 8 1 1 1
1 1 1 1 1 1 1 1