1 1 1 1 1 1 1 1 1
1 1 0 4 0 8 1 1 1
1 1 0 1 0 0 3 0 1
1 4 0 1 1 3 3 8 1
1 0 3 1 1 0 4 0 1
1 2 0 1 1 0 3 3 1
1 1 1 1 1 0 7 0 1
1 1 1 1 1 1 1 1 1