1 1 1 1 1 1 1 1 1
1 1 0 2 0 1 1 1 1
1 1 3 3 3 1 1 1 1
1 0 0 0 6 1 1 1 1
1 1 8 8 0 1 1 1 1
1 1 4 1 3 3 0 0 1
1 1 0 0 3 0 4 1 1
1 1 1 1 1 5 3 0 1
1 1 1 1 1 0 7 1 1
1 1 1 1 1 1 1 1 1