1 1 1 1 1 1 1 1 1
1 1 0 0 0 0 1 1 1
1 1 0 1 8 8 0 0 1
1 3 8 1 1 0 3 0 1
1 0 3 1 1 3 8 3 1
1 7 0 1 1 4 3 0 1
1 1 1 1 1 2 4 0 1
1 1 1 1 1 1 1 1 1