1 1 1 1 1 1 1 1
1 1 1 1 0 2 1 1
1 1 1 0 3 3 0 1
1 7 1 8 0 4 0 1
1 0 1 6 3 0 4 1
1 4 1 3 3 5 3 1
1 8 0 8 4 0 8 1
1 1 1 1 1 1 3 1
1 1 1 1 1 1 1 1