1 1 1 1 1 1 1 1
1 1 1 1 N 0 1 1
1 1 1 1 0 5 0 1
1 0 6 1 3 3 3 1
1 4 3 0 4 3 0 1
1 0 1 4 0 0 2 1
1 81 1 1 82 1 1 1
1 82 81 82 81 1 1 1
1 1 1 1 1 1 1 1