1 1 1 1 1 1 1 1 1 1
1 1 1 1 0 2 0 0 1 1
1 1 1 1 1 1 1 4 1 1
1 1 1 0 8 8 3 3 7 1
1 1 1 8 1 8 1 0 3 1
1 1 1 0 0 0 8 4 1 1
1 0 1 8 1 8 1 0 1 1
1 0 0 0 0 0 0 0 1 1
1 1 1 1 1 1 1 1 1 1