1 1 1 1 1 1 1 1 1
1 1 1 1 1 0 2 1 1
1 1 0 0 0 3 6 1 1
1 1 0 3 0 0 1 1 1
1 3 4 1 1 1 1 1 1
1 0 0 4 3 4 0 1 1
1 4 3 0 0 0 5 7 1
1 1 1 1 1 1 1 1 1