1 1 1 1 1 1 1 1 1 1
1 1 1 1 7 7 7 0 1 1
1 1 1 1 1 1 1 5 1 1
1 1 1 0 8 8 0 0 2 1
1 1 1 8 1 8 1 0 0 1
1 1 1 0 0 4 8 0 1 1
1 6 1 8 1 8 1 0 1 1
1 0 0 0 0 0 4 0 1 1
1 1 1 1 1 1 1 1 1 1