1 1 1 1 1 1 1 1
1 1 1 1 7 5 1 1
1 1 1 3 3 5 0 1
1 4 1 0 3 8 3 1
1 3 1 0 8 3 0 1
1 6 1 0 3 0 4 1
1 6 4 0 0 3 0 1
1 1 1 1 1 1 2 1
1 1 1 1 1 1 1 1