1 1 1 1 1 1 1 1 1
1 1 1 1 1 0 2 1 1
1 1 0 0 4 0 0 1 1
1 1 0 4 0 4 1 1 1
1 0 0 1 1 1 1 1 1
1 0 3 0 0 3 0 1 1
1 0 3 0 3 0 0 7 1
1 1 1 1 1 1 1 1 1