1 1 1 1 1 1 1 1 1
1 1 0 7 0 1 1 1 1
1 1 3 3 3 1 1 1 1
1 4 0 3 0 1 1 1 1
1 1 8 3 0 0 1 1 1
1 1 4 1 0 8 4 3 1
1 1 0 4 0 3 0 1 1
1 1 1 1 1 0 3 0 1
1 1 1 1 1 0 2 1 1
1 1 1 1 1 1 1 1 1