1 1 1 1 1 1 1 1 1 1
1 7 1 8 0 3 1 1 1 1
1 0 3 4 4 0 3 4 1 1
1 4 0 3 8 3 0 0 2 1
1 4 3 0 3 0 3 3 0 1
1 1 8 3 0 3 0 1 1 1
1 1 1 1 1 1 1 1 1 1