1 1 1 1 1 1 1 1
1 1 1 1 7 5 1 1
1 1 1 1 4 3 0 1
1 4 3 1 0 0 0 1
1 0 3 0 0 3 3 1
1 0 1 0 0 0 2 1
1 0 1 1 8 1 1 1
1 0 6 8 8 1 1 1
1 1 1 1 1 1 1 1