1 1 1 1 1 1 1 1 1
1 1 0 2 3 1 1 1 1
1 1 3 4 0 1 1 1 1
1 7 5 0 0 1 1 1 1
1 1 0 8 0 1 1 1 1
1 1 8 1 3 0 3 6 1
1 1 8 8 0 3 0 1 1
1 1 1 1 1 0 3 4 1
1 1 1 1 1 0 6 1 1
1 1 1 1 1 1 1 1 1