1 1 1 1 1 1 1 1
1 1 1 1 0 7 1 1
1 1 1 0 5 3 6 1
1 2 1 3 4 3 0 1
1 4 1 0 3 0 0 1
1 4 1 3 0 3 0 1
1 4 0 4 3 0 3 1
1 1 1 1 1 1 4 1
1 1 1 1 1 1 1 1