1 1 1 1 1 1 1 1 1
1 1 0 0 2 1 1 1 1
1 1 0 4 3 1 1 1 1
1 0 3 0 0 1 1 1 1
1 1 0 3 0 1 1 1 1
1 1 0 1 3 5 5 7 1
1 1 6 0 0 0 3 1 1
1 1 1 1 1 3 4 6 1
1 1 1 1 1 0 3 1 1
1 1 1 1 1 1 1 1 1