1 1 1 1 1 1 1 1
1 1 1 1 2 0 1 1
1 1 1 1 0 0 0 1
1 0 6 1 4 3 3 1
1 4 3 0 4 3 0 1
1 4 1 4 0 5 7 1
1 8 1 1 8 1 1 1
1 8 8 8 8 1 1 1
1 1 1 1 1 1 1 1