1 1 1 1 1 1 1 1 1
1 1 1 1 1 0 7 1 1
1 1 0 0 0 5 0 1 1
1 1 0 0 0 3 1 1 1
1 6 4 1 1 1 1 1 1
1 4 4 0 0 3 0 1 1
1 4 0 0 0 3 0 2 1
1 1 1 1 1 1 1 1 1