1 1 1 1 1 1 1 1
1 1 1 1 1 0 N 1
1 1 1 0 5 3 0 1
1 2 1 82 0 3 0 1
1 0 1 0 82 0 82 1
1 4 1 3 3 3 3 1
1 82 0 82 0 0 82 1
1 1 1 1 1 1 6 1
1 1 1 1 1 1 1 1