1 1 1 1 1 1 1 1 1
1 1 0 0 0 0 1 1 1
1 1 4 1 8 8 0 0 1
1 0 8 1 1 3 3 3 1
1 0 0 1 1 0 8 0 1
1 2 0 1 1 0 4 0 1
1 1 1 1 1 7 0 4 1
1 1 1 1 1 1 1 1 1