1 1 1 1 1 1 1 1 1
1 1 1 1 1 0 0 1 1
1 1 2 0 5 0 5 1 1
1 1 3 6 5 0 1 1 1
1 0 0 5 1 1 1 1 1
1 0 0 0 4 0 0 1 1
1 0 0 0 3 0 3 0 1
1 1 1 1 1 1 1 1 1