1 1 1 1 1 1 1 1 1 1 1
1 1 1 1 0 2 0 1 1 1 1
1 1 1 1 3 6 3 1 1 1 1
1 1 3 1 3 5 3 1 6 1 1
1 3 0 0 3 3 3 0 0 3 1
1 0 3 5 3 0 0 3 3 0 1
1 1 7 0 3 0 0 3 0 1 1
1 1 1 1 1 1 1 1 1 1 1