1 1 1 1 1 1 1 1
1 1 1 1 7 5 1 1
1 1 1 1 0 5 0 1
1 0 6 1 3 3 3 1
1 4 0 4 0 8 0 1
1 0 1 0 0 4 2 1
1 4 1 1 3 1 1 1
1 0 0 6 0 1 1 1
1 1 1 1 1 1 1 1