1 1 1 1 1 1 1 1 1 1
1 1 1 1 7 0 5 0 1 1
1 1 1 1 1 1 1 0 1 1
1 1 1 0 6 3 0 0 2 1
1 1 1 0 1 0 1 8 0 1
1 1 1 5 0 3 8 4 1 1
1 6 1 0 1 8 1 8 1 1
1 0 0 0 8 4 0 3 1 1
1 1 1 1 1 1 1 1 1 1