1 1 1 1 1 1 1 1 1 1
1 2 1 0 5 7 1 1 1 1
1 0 3 0 3 3 0 0 1 1
1 0 3 0 4 8 0 3 6 1
1 0 4 0 3 4 3 0 3 1
1 1 0 3 0 0 0 1 1 1
1 1 1 1 1 1 1 1 1 1