1 1 1 1 1 1 1 1
1 1 1 1 0 7 1 1
1 1 1 0 5 3 0 1
1 2 1 8 0 3 0 1
1 0 1 0 8 0 8 1
1 4 1 3 3 3 3 1
1 8 0 8 0 0 8 1
1 1 1 1 1 1 6 1
1 1 1 1 1 1 1 1