1 1 1 1 1 1 1 1
1 0 0 0 0 0 0 1
1 0 2 0 7 0 7 1
1 6 0 0 6 0 0 1
1 5 0 0 5 0 0 1
1 0 4 0 4 0 0 1
1 0 0 0 3 0 3 1
1 1 1 1 1 1 1 1