1 1 1 1 1 1 1 1
1 1 1 1 6 0 1 1
1 1 1 1 4 0 3 1
1 0 0 1 0 3 8 1
1 0 3 0 0 3 0 1
1 3 1 0 0 0 0 1
1 0 1 1 5 1 1 1
1 2 3 3 7 1 1 1
1 1 1 1 1 1 1 1