1 1 1 1 1 1 1 1 1 1
1 1 1 1 0 2 0 0 1 1
1 1 1 1 1 1 1 4 1 1
1 1 1 0 8 8 0 3 0 1
1 1 1 8 1 3 1 0 3 1
1 1 1 4 0 4 8 4 1 1
1 7 1 3 1 3 1 0 1 1
1 0 0 0 8 0 8 0 1 1
1 1 1 1 1 1 1 1 1 1