1 1 1 1 1 1 1 1 1 1 1
1 1 1 1 0 0 0 1 1 1 1
1 1 1 1 3 5 3 1 1 1 1
1 1 3 1 3 0 0 1 0 1 1
1 3 0 0 3 3 3 0 0 6 1
1 0 3 3 3 0 0 3 3 0 1
1 1 2 0 3 0 0 3 0 1 1
1 1 1 1 1 1 1 1 1 1 1