#######
#     #
# B P #
#     #
#  T  #
#######