########
#......#
#.S.P..#
#..B...#
########